1,1,1,1,1,1,1,1,1,1,1,1,1,1,1,1
1,2,2,2,2,1,2,2,2,2,1,2,2,2,2,1
1,2,3,3,2,1,2,3,3,2,1,2,3,3,2,1
1,2,3,3,3,1,3,3,3,2,1,2,3,3,2,1
1,2,2,2,2,1,2,2,2,2,1,2,2,3,2,1
1,1,1,1,1,1,1,1,1,1,1,1,1,1,1,1
1,2,2,2,2,1,1,1,1,1,1,1,1,1,1,1
1,2,3,3,2,1,1,1,1,1,1,1,1,1,1,1
1,2,3,3,2,1,1,1,1,1,1,1,1,1,1,1
1,2,3,2,2,1,1,1,1,13,5,5,5,5,5,5
1,1,1,1,13,5,5,5,5,9,4,4,4,4,4,4
1,1,1,13,9,4,4,4,4,4,4,4,4,4,4,4
5,5,5,9,4,4,4,4,4,4,4,4,4,4,4,4
4,4,4,4,4,4,4,4,4,4,4,4,4,4,4,4
4,4,4,4,4,4,4,4,4,4,4,4,4,4,4,4
4,4,4,4,4,4,4,4,4,4,4,4,4,4,4,4
